As a dare, your friends tell you to walk through an acclaimed haunted house and open the upstairs window to prove you made it through. You stand inside the house's main room. The door closes behind you.

haunted house
An Interactive Fiction by Melissa Oshiro
Release 1 / Serial number 140917 / Inform 7 build 6L02 (I6/v6.33 lib 6/12N) SD

Darkness
It is pitch dark, and you can't see a thing.

>i
You are carrying:
  flashlight
  snickers bar

>turn on flashlight
Now that your flashlight is on, you feel safer, but also like a character in a scary movie.

Main room
A large dusty room with couches in the middle and a few shelves pressed against the walls. A small chandelier hangs from the ceiling. To the West, North, and East are dark hallways.

>eat snickers bar
That's plainly inedible.

>x main room
You can't see any such thing.

>x me
You are a giant crab.

>w
West Hall
You see an open door at the end of the hall. A dim light seems to be coming from inside the room.

>x west hall
I only understood you as far as wanting to examine west.

>s
You can't go that way.

>e
Main room
A large dusty room with couches in the middle and a few shelves pressed against the walls. A small chandelier hangs from the ceiling. To the West, North, and East are dark hallways.

>n
North hall
Three doorways are in this hall. The doorway to the west opens to a dining room, the door to the east seems to be a kitchen, and there is a mysterious door at the end of the hall.

You can see stairs and kitchenn door here.

>open door
(kitchenn door)
It seems to be locked.

>unlock door
What do you want to unlock kitchenn door with?

>e
I didn't understand that sentence.

>e
(first opening kitchenn door)
It seems to be locked.

>w
Dining room
A long table that seats ten people sits in the middle of the room. A dusty chandelier hangs from the ceiling and a carpet lines the floor.

>look under table
You can't see any such thing.

>look under carpet
You can't see any such thing.

>n
You can't go that way.

>s
You can't go that way.

>e
North hall
Three doorways are in this hall. The doorway to the west opens to a dining room, the door to the east seems to be a kitchen, and there is a mysterious door at the end of the hall.

You can see stairs and kitchenn door here.

>s
Main room
A large dusty room with couches in the middle and a few shelves pressed against the walls. A small chandelier hangs from the ceiling. To the West, North, and East are dark hallways.

>e
East Hall
You see a door at the end of the hall.

You can see East door here.

>open east door
It seems to be locked.

>unlock east door
What do you want to unlock East door with?

>unlock east door with snickers bar
That doesn't seem to fit the lock.

>n
You can't go that way.

>e
(first opening East door)
It seems to be locked.

>s
You can't go that way.

>w
Main room
A large dusty room with couches in the middle and a few shelves pressed against the walls. A small chandelier hangs from the ceiling. To the West, North, and East are dark hallways.

>w
West Hall
You see an open door at the end of the hall. A dim light seems to be coming from inside the room.

>w
Library
The library's walls are filled with books. You see a desk with a lit candle in the middle of the room. Weird, this house is supposed to be deserted.

On library desk is office-key.

>take key
You can't see any such thing.

>take office-key
Taken.

>n
You can't go that way.

* * *

>s
You can't go that way.

>e
West Hall
You see an open door at the end of the hall. A dim light seems to be coming from inside the room.

>e
Main room
A large dusty room with couches in the middle and a few shelves pressed against the walls. A small chandelier hangs from the ceiling. To the West, North, and East are dark hallways.

* * *

>n
North hall
Three doorways are in this hall. The doorway to the west opens to a dining room, the door to the east seems to be a kitchen, and there is a mysterious door at the end of the hall.

You can see stairs and kitchenn door here.

>open door with key
You can't see any such thing.

>unlock door with key
You can't see any such thing.

>open door
(kitchenn door)
It seems to be locked.

>s
Main room
A large dusty room with couches in the middle and a few shelves pressed against the walls. A small chandelier hangs from the ceiling. To the West, North, and East are dark hallways.

>w
West Hall
You see an open door at the end of the hall. A dim light seems to be coming from inside the room.

>w
Library
The library's walls are filled with books. You see a desk with a lit candle in the middle of the room. Weird, this house is supposed to be deserted.

>w
You can't go that way.

>e
West Hall
You see an open door at the end of the hall. A dim light seems to be coming from inside the room.

>w
Library
The library's walls are filled with books. You see a desk with a lit candle in the middle of the room. Weird, this house is supposed to be deserted.

>s
You can't go that way.

>n
You can't go that way.

* * *

>s
You can't go that way.

>w
You can't go that way.

>n
You can't go that way.

>e
West Hall
You see an open door at the end of the hall. A dim light seems to be coming from inside the room.

* * *

>n
North hall
Three doorways are in this hall. The doorway to the west opens to a dining room, the door to the east seems to be a kitchen, and there is a mysterious door at the end of the hall.

You can see stairs and kitchenn door here.

>s
Main room
A large dusty room with couches in the middle and a few shelves pressed against the walls. A small chandelier hangs from the ceiling. To the West, North, and East are dark hallways.

* * *

>e
East Hall
You see a door at the end of the hall.

You can see East door here.

>open door
It seems to be locked.

>unlock door with key
You can't see any such thing.

>s
You can't go that way.

>e
(first opening East door)
It seems to be locked.

>w
Main room
A large dusty room with couches in the middle and a few shelves pressed against the walls. A small chandelier hangs from the ceiling. To the West, North, and East are dark hallways.

>n
North hall
Three doorways are in this hall. The doorway to the west opens to a dining room, the door to the east seems to be a kitchen, and there is a mysterious door at the end of the hall.

You can see stairs and kitchenn door here.

>n
You can't go that way.

>e
(first opening kitchenn door)
It seems to be locked.

* * *

>w
Dining room
A long table that seats ten people sits in the middle of the room. A dusty chandelier hangs from the ceiling and a carpet lines the floor.

>w
You can't go that way.

>s
You can't go that way.

* * *

>s
Main room
A large dusty room with couches in the middle and a few shelves pressed against the walls. A small chandelier hangs from the ceiling. To the West, North, and East are dark hallways.

>n
North hall
Three doorways are in this hall. The doorway to the west opens to a dining room, the door to the east seems to be a kitchen, and there is a mysterious door at the end of the hall.

You can see stairs and kitchenn door here.

* * *

>n
You can't go that way.

>go up stairs
I only understood you as far as wanting to go up.

>go up
Attic
A dark room that seems to be full of abandoned things like couches and stuff. the moon comes through the window and casts shadows across the room.

You can see stairs and window (closed) here.

>open window
    *** When you open the window, you see a dark shadow move behind you in the reflection of the glass. You turn around to look and see a dark shadowy figure standing before you. It opens its mouth and eats your head. THE END. ***

Would you like to RESTART, RESTORE a saved game, QUIT or UNDO the last command?

>undo
Attic
[Previous turn undone.]

>x couch
You can't see any such thing.

>go down
North hall
Three doorways are in this hall. The doorway to the west opens to a dining room, the door to the east seems to be a kitchen, and there is a mysterious door at the end of the hall.

You can see stairs and kitchenn door here.

>s
Main room
A large dusty room with couches in the middle and a few shelves pressed against the walls. A small chandelier hangs from the ceiling. To the West, North, and East are dark hallways.

* * *

>unlock door with key
You can't see any such thing.

>e
(first opening East door)
It seems to be locked.

* * *

>n
You can't go that way.

>w
Main room
A large dusty room with couches in the middle and a few shelves pressed against the walls. A small chandelier hangs from the ceiling. To the West, North, and East are dark hallways.

>e
East Hall
You see a door at the end of the hall.

You can see East door here.

* * *

>turn on flashlight
Now that your flashlight is on, you feel safer, but also like a character in a scary movie.

Main room
A large dusty room with couches in the middle and a few shelves pressed against the walls. A small chandelier hangs from the ceiling. To the West, North, and East are dark hallways.

>look on sheleves
You can't see any such thing.

>look on shelves
You can't see any such thing.

>look under couch
You can't see any such thing.

>w
West Hall
You see an open door at the end of the hall. A dim light seems to be coming from inside the room.

* * *

>w
Library
The library's walls are filled with books. You see a desk with a lit candle in the middle of the room. Weird, this house is supposed to be deserted.

On library desk is office-key.

>look at books
You can't see any such thing.

>take office-key
Taken.

>x desk
(library desk)
An old wooden desk with a single drawer that seems to be unlocked.  A key and matches sit next to the lit candle.

>look in drawer
You can't see inside, since desk drawer is closed.

>open drawer
You open desk drawer.

>e
West Hall
You see an open door at the end of the hall. A dim light seems to be coming from inside the room.

* * *

>e
East Hall
You see a door at the end of the hall.

You can see East door here.

>e
(first opening East door)
It seems to be locked.

>i
You are carrying:
  office-key
  flashlight (providing light)
  snickers bar

>open door with office-key
You unlock East door.

>e
(first opening East door)

office
A small room with a tacky rug spread on the floor.

You can see East door and cabinet (closed) here.

>open cabinet
You open cabinet, revealing kitchen-key.

>take key
You can't see any such thing.

>take  kitchen-key
Taken.

>w
East Hall
You see a door at the end of the hall.

You can see East door here.

>w
Main room
A large dusty room with couches in the middle and a few shelves pressed against the walls. A small chandelier hangs from the ceiling. To the West, North, and East are dark hallways.

* * *

>n
North hall
Three doorways are in this hall. The doorway to the west opens to a dining room, the door to the east seems to be a kitchen, and there is a mysterious door at the end of the hall.

You can see stairs and kitchenn door here.

>e
(first opening kitchenn door)
It seems to be locked.

>open door with kitchen-key
(kitchenn door with kitchen-key)
You unlock kitchenn door.

>e
(first opening kitchenn door)

kitchen
Counters run along the north and east walls. Two sinks are on the north wall, a refrigerator is on the east wall, and an oven and stove on the west wall. A knife sits on the north counter, next to the sinks.

You can see kitchenn door and refrigerator (closed) here.

>open refrigerator
You open refrigerator, revealing Demon head.

The demon head floats and follows you. It looks hungry??

>give snickers bar
(to Demon head)
You place the snickers bar in the mouth of the demon head and it spits a rusty key back out at you.

The demon head floats and follows you. It looks hungry??

>i
You are carrying:
  attic-key
  kitchen-key
  office-key
  flashlight (providing light)

The demon head floats and follows you. It looks hungry??

>w
North hall
Three doorways are in this hall. The doorway to the west opens to a dining room, the door to the east seems to be a kitchen, and there is a mysterious door at the end of the hall.

You can see kitchenn door and stairs here.

The demon head floats and follows you. It looks hungry??

>go upstairs
You can't see any such thing.

>n
You can't go that way.

The demon head floats and follows you. It looks hungry??

>go up
Attic
A dark room that seems to be full of abandoned things like couches and stuff. the moon comes through the window and casts shadows across the room.

You can see stairs and window (closed) here.

The demon head floats and follows you. It looks hungry??

>open window
    *** When you open the window, you see a dark shadow move behind you in the reflection of the glass. You turn around to look and see a dark shadowy figure standing before you. It opens its mouth and eats your head. THE END. ***

Would you like to RESTART, RESTORE a saved game, QUIT or UNDO the last command?

* * *

>turn on flashlight
Now that your flashlight is on, you feel safer, but also like a character in a scary movie.

Main room
A large dusty room with couches in the middle and a few shelves pressed against the walls. A small chandelier hangs from the ceiling. To the West, North, and East are dark hallways.

>take couch
You can't see any such thing.

>take couches
You can't see any such thing.

>take shelves
You can't see any such thing.

>take chandelier
You can't see any such thing.

>west
West Hall
You see an open door at the end of the hall. A dim light seems to be coming from inside the room.

>go west
Library
The library's walls are filled with books. You see a desk with a lit candle in the middle of the room. Weird, this house is supposed to be deserted.

On library desk is office-key.

>take desk
(library desk)
That's hardly portable.

>i
You are carrying:
  flashlight (providing light)
  snickers bar

>take lit candle
Taken.

>take office-key
Taken.

>go east
West Hall
You see an open door at the end of the hall. A dim light seems to be coming from inside the room.

>e
Main room
A large dusty room with couches in the middle and a few shelves pressed against the walls. A small chandelier hangs from the ceiling. To the West, North, and East are dark hallways.

* * *

>n
North hall
Three doorways are in this hall. The doorway to the west opens to a dining room, the door to the east seems to be a kitchen, and there is a mysterious door at the end of the hall.

You can see stairs and kitchenn door here.

>w
Dining room
A long table that seats ten people sits in the middle of the room.

>take table
You can't see any such thing.

>take long table
You can't see any such thing.

>take seats
You can't see any such thing.

>take all
Yo man only one thing at a time.

>e
North hall
Three doorways are in this hall. The doorway to the west opens to a dining room, the door to the east seems to be a kitchen, and there is a mysterious door at the end of the hall.

You can see stairs and kitchenn door here.

>e
(first opening kitchenn door)
It seems to be locked.

>open kitchenn door
It seems to be locked.

>i
You are carrying:
  office-key
  candle
  flashlight (providing light)
  snickers bar

>go n
You can't go that way.

>n
You can't go that way.

>open mysterious door
It seems to be locked.

>open mysterious door with office-key
That doesn't seem to fit the lock.

>go s
Main room
A large dusty room with couches in the middle and a few shelves pressed against the walls. A small chandelier hangs from the ceiling. To the West, North, and East are dark hallways.

>e
East Hall
You see a door at the end of the hall.

You can see East door here.

* * *

>open east door
It seems to be locked.

>unlock east door wiht office-key
I didn't understand that sentence.

>unlock east door with office-key
You unlock East door.

>go e
(first opening East door)

office
A small room with a tacky rug spread on the floor.

You can see East door and cabinet (closed) here.

>take tacky rug
You can't see any such thing.

>take cabinet
Taken.

>open cabinet
You open cabinet, revealing kitchen-key.

>take kitchen-key
Taken.

>go w
East Hall
You see a door at the end of the hall.

You can see East door here.

>go w
Main room
A large dusty room with couches in the middle and a few shelves pressed against the walls. A small chandelier hangs from the ceiling. To the West, North, and East are dark hallways.

>w
West Hall
You see an open door at the end of the hall. A dim light seems to be coming from inside the room.

>e
Main room
A large dusty room with couches in the middle and a few shelves pressed against the walls. A small chandelier hangs from the ceiling. To the West, North, and East are dark hallways.

* * *

>e
(first opening kitchenn door)
It seems to be locked.

>open kitchenn door with kitchenn-key
You can't see any such thing.

>open kitchenn door with kitchen-key
You unlock kitchenn door.

>go e
(first opening kitchenn door)

kitchen
Counters run along the north and east walls. Two sinks are on the north wall, a refrigerator is on the east wall, and an oven and stove on the west wall. A knife sits on the north counter, next to the sinks.

You can see kitchenn door and refrigerator (closed) here.

>x walls
You can't see any such thing.

>take sinks
You can't see any such thing.

>take refrigerator
Taken.

>open refridgerator
You can't see any such thing.

>take oven
You can't see any such thing.

>open refrigerator
You open refrigerator, revealing Demon head.

The demon head floats and follows you.

>talk to demon head
That's not a verb I recognise.

>banish demon head
That's not a verb I recognise.

>give demon head snickers bar
You place the snickers bar in the mouth of the demon head and it spits a rusty key back out at you.

The demon head floats and follows you.

>x demon head
A strange monsterous-like head that is decomposing. It reeks and you almost puke, but you see something shiny in its mouth. A key?

The demon head floats and follows you.

>take key
You can't see any such thing.

>i
You are carrying:
  attic-key
  refrigerator (open but empty)
  kitchen-key
  cabinet (open but empty)
  office-key
  candle
  flashlight (providing light)

The demon head floats and follows you.

>go w
North hall
Three doorways are in this hall. The doorway to the west opens to a dining room, the door to the east seems to be a kitchen, and there is a mysterious door at the end of the hall.

You can see kitchenn door and stairs here.

The demon head floats and follows you.

>open mysterious door with attic-key
You unlock mysterious door.

The demon head floats and follows you.

>go up
Attic
A dark room that seems to be full of abandoned things like couches and stuff. the moon comes through the window and casts shadows across the room.

You can see stairs here.

The demon head floats and follows you.

* * *

>turn on flashlight
Now that your flashlight is on, you feel safer, but also like a character in a scary movie.

Main room
A large dusty room with couches in the middle and a few shelves pressed against the walls. A small chandelier hangs from the ceiling. To the West, North, and East are dark hallways.

>x couches
You can't see any such thing.

>x shelves
You can't see any such thing.

>w
West Hall
You see an open door at the end of the hall. A dim light seems to be coming from inside the room.

>n
You can't go that way.

I beg your pardon?

>w
Library
The library's walls are filled with books. You see a desk with a lit candle in the middle of the room. Weird, this house is supposed to be deserted.

On library desk is office-key.

>take candle
Taken.

>take office-key
Taken.

>e
West Hall
You see an open door at the end of the hall. A dim light seems to be coming from inside the room.

* * *

>n
North hall
Three doorways are in this hall. The doorway to the west opens to a dining room, the door to the east seems to be a kitchen, and there is a mysterious door at the end of the hall.

You can see stairs and kitchenn door here.

>w
Dining room
A long table that seats ten people sits in the middle of the room. A dusty chandelier hangs from the ceiling and a carpet lines the floor.

>take all
Yo man only one thing at a time.

>x table
You can't see any such thing.

>x table
You can't see any such thing.

>x chandelier
You can't see any such thing.

>x carpet
You can't see any such thing.

>e
North hall
Three doorways are in this hall. The doorway to the west opens to a dining room, the door to the east seems to be a kitchen, and there is a mysterious door at the end of the hall.

You can see stairs and kitchenn door here.

* * *

>e
(first opening kitchenn door)
It seems to be locked.

>i
You are carrying:
  office-key
  candle
  flashlight (providing light)
  snickers bar

>open mysterious door with office-key
That doesn't seem to fit the lock.

>e
(first opening kitchenn door)
It seems to be locked.

>n
You can't go that way.

>s
Main room
A large dusty room with couches in the middle and a few shelves pressed against the walls. A small chandelier hangs from the ceiling. To the West, North, and East are dark hallways.

* * *

>e
(first opening East door)
It seems to be locked.

>open east door with office-key
You unlock East door.

>e
(first opening East door)

office
A small room with a tacky rug spread on the floor.

You can see East door and cabinet (closed) here.

* * *

>take kitchen-key
Taken.

>w
East Hall
You see a door at the end of the hall.

You can see East door here.

* * *

>n
North hall
Three doorways are in this hall. The doorway to the west opens to a dining room, the door to the east seems to be a kitchen, and there is a mysterious door at the end of the hall.

You can see stairs and kitchenn door here.

>open kitchenn with kitchen-key
You unlock kitchenn door.

>n
You can't go that way.

>e
(first opening kitchenn door)

kitchen
Counters run along the north and east walls. Two sinks are on the north wall, a refrigerator is on the east wall, and an oven and stove on the west wall. A knife sits on the north counter, next to the sinks.

You can see kitchenn door and refrigerator (closed) here.

>take fridge
You can't see any such thing.

>take oven
You can't see any such thing.

>take stove
You can't see any such thing.

>take knife
Taken.

>x knife
A large cleaver that is particularly shiny. When you hold it up, you see something dark move behind you in its reflection.

>talk to ghost
That's not a verb I recognise.

>w
North hall
Three doorways are in this hall. The doorway to the west opens to a dining room, the door to the east seems to be a kitchen, and there is a mysterious door at the end of the hall.

You can see kitchenn door and stairs here.

>open mysterious door
It seems to be locked.

>i
You are carrying:
  knife
  kitchen-key
  office-key
  candle
  flashlight (providing light)
  snickers bar

>e
kitchen
Counters run along the north and east walls. Two sinks are on the north wall, a refrigerator is on the east wall, and an oven and stove on the west wall. A knife sits on the north counter, next to the sinks.

You can see kitchenn door and refrigerator (closed) here.

>open fridge
You can't see any such thing.

>open refridgerator
You can't see any such thing.

>open refrigerator
You open refrigerator, revealing Demon head.

The demon head floats and follows you.

* * *

>talk to demon head
That's not a verb I recognise.

>w
North hall
Three doorways are in this hall. The doorway to the west opens to a dining room, the door to the east seems to be a kitchen, and there is a mysterious door at the end of the hall.

You can see kitchenn door and stairs here.

The demon head floats and follows you.

>up
Attic
A dark room that seems to be full of abandoned things like couches and stuff. the moon comes through the window and casts shadows across the room.

You can see stairs and window (closed) here.

The demon head floats and follows you.

* * *

As a dare, your friends tell you to walk through an acclaimed haunted house and open the upstairs window to prove you made it through. You stand inside the house's main room. The door closes behind you.

haunted house
An Interactive Fiction by Melissa Oshiro
Release 1 / Serial number 140917 / Inform 7 build 6L02 (I6/v6.33 lib 6/12N) SD

Darkness
It is pitch dark, and you can't see a thing.

>w
Darkness
It is pitch dark, and you can't see a thing.

>turn on flashlight
Now that your flashlight is on, you feel safer, but also like a character in a scary movie.

West Hall
You see an open door at the end of the hall. A dim light seems to be coming from inside the room.

>w
Library
The library's walls are filled with books. You see a desk with a lit candle in the middle of the room. Weird, this house is supposed to be deserted.

On library desk is office-key.

>take office-key
Taken.

* * *

>e
Main room
A large dusty room with couches in the middle and a few shelves pressed against the walls. A small chandelier hangs from the ceiling. To the West, North, and East are dark hallways.

>e
East Hall
You see a door at the end of the hall.

You can see Office-door here.

>e
(first opening Office-door)
It seems to be locked.

>unlock door
What do you want to unlock Office-door with?

>office-key
You unlock Office-door.

>unlock door with key
That's unlocked at the moment.

>unlock door
What do you want to unlock Office-door with?

>key
That's unlocked at the moment.

>unlock door with key
That's unlocked at the moment.

>undo
East Hall
[Previous turn undone.]

>undo
East Hall
[Previous turn undone.]

>undo
Main room
[Previous turn undone.]

>e
East Hall
You see a door at the end of the hall.

You can see Office-door here.

>unlock door
What do you want to unlock Office-door with?

>key
You unlock Office-door.

>open door
You open Office-door.

>e
office
A small room with a tacky rug spread on the floor.

You can see Office-door and cabinet (closed) here.

>open cabinet
You open cabinet, revealing kitchen-key.

>take key
(kitchen-key)
Taken.

>w
East Hall
You see a door at the end of the hall.

You can see Office-door here.

>w
Main room
A large dusty room with couches in the middle and a few shelves pressed against the walls. A small chandelier hangs from the ceiling. To the West, North, and East are dark hallways.

* * *

>e
(first opening kitchenn door)
It seems to be locked.

>unlock door
What do you want to unlock kitchenn door with?

>key
I didn't understand that sentence.

>unlock door with key
Which do you mean, kitchen-key or office-key?

>kitchen-key
(kitchenn door with kitchen-key)
You unlock kitchenn door.

>open door
(kitchenn door)
You open kitchenn door.

>e
kitchen
Counters run along the north and east walls. Two sinks are on the north wall, a refrigerator is on the east wall, and an oven and stove on the west wall. A knife sits on the north counter, next to the sinks.

You can see kitchenn door and refrigerator (closed) here.

>open refrigerator
You open refrigerator, revealing Demon head.

The demon head floats and follows you. It looks hungry??

>w
North hall
Three doorways are in this hall. The doorway to the west opens to a dining room, the door to the east seems to be a kitchen, and there is a mysterious door at the end of the hall.

You can see kitchenn door and stairs here.

The demon head floats and follows you. It looks hungry??

>give snickers bar
(to Demon head)
You place the snickers bar in the mouth of the demon head and it spits a rusty key back out at you.

>s
Main room
A large dusty room with couches in the middle and a few shelves pressed against the walls. A small chandelier hangs from the ceiling. To the West, North, and East are dark hallways.

>n
North hall
Three doorways are in this hall. The doorway to the west opens to a dining room, the door to the east seems to be a kitchen, and there is a mysterious door at the end of the hall.

You can see kitchenn door and stairs here.

>n
You can't go that way.

>open attic door
You can't see any such thing.

>open mysterious door
It seems to be locked.

>e
kitchen
Counters run along the north and east walls. Two sinks are on the north wall, a refrigerator is on the east wall, and an oven and stove on the west wall. A knife sits on the north counter, next to the sinks.

You can see kitchenn door and refrigerator (empty) here.

>w
North hall
Three doorways are in this hall. The doorway to the west opens to a dining room, the door to the east seems to be a kitchen, and there is a mysterious door at the end of the hall.

You can see kitchenn door and stairs here.

>w
Dining room
A long table that seats ten people sits in the middle of the room. A dusty chandelier hangs from the ceiling and a carpet lines the floor.

You can see Dining-table and Mirror here.

>x mirror
An oval-shaped mirror with a gold frame. In the dusty reflection, it looks like a figure is standing behind the table in back of you.

>i
You are carrying:
  attic-key
  kitchen-key
  office-key
  flashlight (providing light)

>e
North hall
Three doorways are in this hall. The doorway to the west opens to a dining room, the door to the east seems to be a kitchen, and there is a mysterious door at the end of the hall.

You can see kitchenn door and stairs here.

>unlock door
What do you want to unlock kitchenn door with?

>unlock mysterious door
What do you want to unlock mysterious door with?

>attic-key
You unlock mysterious door.

>open door
(kitchenn door)
That's already open.

>open mysterious door
You open mysterious door.

>n
You can't go that way.

>go up
Attic
A dark room that seems to be full of abandoned things like couches and stuff. the moon comes through the window and casts shadows across the room.

You can see stairs and window (closed) here.

* * *

>undo
Attic
[Previous turn undone.]

>undo
North hall
[Previous turn undone.]

>undo
North hall
[Previous turn undone.]

>undoi
That's not a verb I recognise.

>undo
North hall
[Previous turn undone.]

>undo
The use of "undo" is forbidden in this game.

>undo
The use of "undo" is forbidden in this game.

>w
Dining room
A long table that seats ten people sits in the middle of the room. A dusty chandelier hangs from the ceiling and a carpet lines the floor.

You can see Dining-table and Mirror here.

>i
You are carrying:
  attic-key
  kitchen-key
  office-key
  flashlight (providing light)

>give snickers bar
You can't see any such thing.

>w
You can't go that way.

>i
You are carrying:
  attic-key
  kitchen-key
  office-key
  flashlight (providing light)

* * *

As a dare, your friends tell you to walk through an acclaimed haunted house and open the upstairs window to prove you made it through. You stand inside the house's main room. The door closes behind you.

haunted house
An Interactive Fiction by Melissa Oshiro
Release 1 / Serial number 140917 / Inform 7 build 6L02 (I6/v6.33 lib 6/12N) SD

Darkness
It is pitch dark, and you can't see a thing.

>go west
West Hall
You see an open door at the end of the hall.

>west
Library
The library's walls are filled with books. You see a desk with a lit candle in the middle of the room. Weird, this house is supposed to be deserted.

>x desk
(library desk)
An old wooden desk with a single drawer that seems to be unlocked.  A key and matches sit next to the lit candle.

>take all
Yo man only one thing at a time.

* * *

>go west
West Hall
You see an open door at the end of the hall.

>go west
Library
The library's walls are filled with books. You see a desk with a lit candle in the middle of the room. Weird, this house is supposed to be deserted.

>x desk
(library desk)
An old wooden desk with a single drawer that seems to be unlocked.  A key and matches sit next to the lit candle.

>x key
a large brass key

* * *

>x desk
(library desk)
An old wooden desk with a single drawer that seems to be unlocked.  A key and matches sit next to the lit candle.

>take candle
Taken.

>take matches
Taken.

>take key
Taken.

>go east
West Hall
You see an open door at the end of the hall.

>go east
Main room
A large dusty room with couches in the middle and a few shelves pressed against the walls. A small chandelier hangs from the ceiling. To the West, North, and East are dark hallways.

>go east
East Hall
You see a door at the end of the hall.

>unlock door
What do you want to unlock East Door with?

>unlock door with key
You unlock East Door.

>go east
You can't go that way.

>open door
You open East Door.

* * *

>take candle
Taken.

>x desk
(library desk)
An old wooden desk with a single drawer that seems to be unlocked.  A key and matches sit next to the lit candle.

>take matches
Taken.

>open desk
(library desk)
It isn't something you can open.

>open desk drawer
You open desk drawer.

* * *

>go west
Library
The library's walls are filled with books. You see a desk with a lit candle in the middle of the room. Weird, this house is supposed to be deserted.

>x library desk
An old wooden desk with a single drawer that seems to be unlocked. A key and matches sit on top of the desk, next to the lamp.

>open drawr
You can't see any such thing.

* * *

As a dare, your friends tell you to walk through an acclaimed haunted house and open the upstairs window to prove you made it through. You stand inside the house's main room. The door closes behind you.

haunted house
An Interactive Fiction by Melissa Oshiro
Release 1 / Serial number 140917 / Inform 7 build 6L02 (I6/v6.33 lib 6/12N) SD

Darkness
It is pitch dark, and you can't see a thing.

>turn on flashlight
Now that your flashlight is on, you feel safer, but also like a character in a scary movie.

Main room
A large dusty room with couches in the middle and a few shelves pressed against the walls. A small chandelier hangs from the ceiling. To the West, North, and East are dark hallways.

>w
West Hall
You see an open door at the end of the hall. A dim light seems to be coming from inside the room.

* * *

>e
Main room
A large dusty room with couches in the middle and a few shelves pressed against the walls. A small chandelier hangs from the ceiling. To the West, North, and East are dark hallways.

>e
East Hall
You see a door at the end of the hall.

You can see East door here.

* * *

>open door
It seems to be locked.

>unlock door
What do you want to unlock East door with?

>key
You can't see any such thing.

>office-key
That's not a verb I recognise.

>unlock door with office-key
You unlock East door.

>e
(first opening East door)

office
A small room with a tacky rug spread on the floor.

You can see East door and cabinet (closed) here.

* * *

>open cabinet
You open cabinet, revealing kitchen-key.

>take kitchen-kay
Taken.

>w
East Hall
You see a door at the end of the hall.

You can see East door here.

* * *

>e
(first opening kitchenn door)
It seems to be locked.

>unlock kitchenn door
What do you want to unlock kitchenn door with?

>kitchen-key
You unlock kitchenn door.

>open door
(kitchenn door)
You open kitchenn door.

>w
Dining room
A long table that seats ten people sits in the middle of the room.

>e
North hall
Three doorways are in this hall. The doorway to the west opens to a dining room, the door to the east seems to be a kitchen, and there is a mysterious door at the end of the hall.

You can see stairs and kitchenn door here.

>e
kitchen
Counters run along the north and east walls. Two sinks are on the north wall, a refrigerator is on the east wall, and an oven and stove on the west wall. A knife sits on the north counter, next to the sinks.

You can see kitchenn door and refrigerator (closed) here.

>open refrigerator
You open refrigerator, revealing Demon head.

The demon head floats and follows you.

>give snickers bar
(to Demon head)
You place the snickers bar in the mouth of the demon head and it spits a rusty key back out at you.

The demon head floats and follows you.

>e
You can't go that way.

The demon head floats and follows you.

>w
North hall
Three doorways are in this hall. The doorway to the west opens to a dining room, the door to the east seems to be a kitchen, and there is a mysterious door at the end of the hall.

You can see kitchenn door and stairs here.

The demon head floats and follows you.

>n
You can't go that way.

The demon head floats and follows you.

>n
You can't go that way.

The demon head floats and follows you.

>unlock mysterious door
What do you want to unlock mysterious door with?

>key
You can't see any such thing.

>i
You are carrying:
  attic-key
  kitchen-key
  office-key
  flashlight (providing light)

The demon head floats and follows you.

>unlock mysterious door with attic-key
You unlock mysterious door.

The demon head floats and follows you.

>go up
Attic
A dark room that seems to be full of abandoned things like couches and stuff. the moon comes through the window and casts shadows across the room.

You can see stairs and window (closed) here.

The demon head floats and follows you.

>open window
    *** When you open the window, you see a dark shadow move behind you in the reflection of the glass. You turn around to look and see a dark shadowy figure standing before you. It opens its mouth and eats your head. THE END. ***

Would you like to RESTART, RESTORE a saved game, QUIT or UNDO the last command?

>x window
Please give one of the answers above.

Would you like to RESTART, RESTORE a saved game, QUIT or UNDO the last command?

* * *

>turn on flashlight
Now that your flashlight is on, you feel safer, but also like a character in a scary movie.

Main room
A large dusty room with couches in the middle and a few shelves pressed against the walls. A small chandelier hangs from the ceiling. To the West, North, and East are dark hallways.

>e
East Hall
You see a door at the end of the hall.

You can see Office-door here.

>open door
It seems to be locked.

>w
Main room
A large dusty room with couches in the middle and a few shelves pressed against the walls. A small chandelier hangs from the ceiling. To the West, North, and East are dark hallways.

* * *

>take candle
Taken.

>take key
Taken.

>x desk
(library desk)
An old wooden desk with a single drawer that seems to be unlocked.  A key and matches sit next to the lit candle.

>take key
You already have that.

>take matches
Taken.

>open drawer
A severed hand jumps out at you and grabs your arm. You try to beat it away with your flashlight, but it grabs the flashlight instead. You drop it and run.

Darkness
It is pitch dark, and you can't see a thing.

>turn on candle
Your lit candle casts an eerie glow around you. Its light is not that strong, so be wary of your surroundings.

West Hall
You see an open door at the end of the hall. A dim light seems to be coming from inside the room.

>e
Main room
A large dusty room with couches in the middle and a few shelves pressed against the walls. A small chandelier hangs from the ceiling. To the West, North, and East are dark hallways.

* * *

>e
(first opening kitchenn door)
It seems to be locked.

>w
Dining room
A long table that seats ten people sits in the middle of the room. A dusty chandelier hangs from the ceiling and a carpet lines the floor.

You can see Dining-table and Mirror here.

* * *

>x mirror
An oval-shaped mirror with a gold frame. In the dusty reflection, it looks like a figure is standing behind the table in back of you.

>x dining-table
A solid mahogany table. Very dusty.

>w
You can't go that way.

* * *

>n
You can't go that way.

>e
North hall
Three doorways are in this hall. The doorway to the west opens to a dining room, the door to the east seems to be a kitchen, and there is a mysterious door at the end of the hall.

You can see stairs and kitchenn door here.

* * *

>s
Main room
A large dusty room with couches in the middle and a few shelves pressed against the walls. A small chandelier hangs from the ceiling. To the West, North, and East are dark hallways.

>e
East Hall
You see a door at the end of the hall.

You can see Office-door here.

* * *

>open door
It seems to be locked.

>unlock door
What do you want to unlock Office-door with?

>keu
You can't see any such thing.

>key
That's not a verb I recognise.

>unlock door with key
You unlock Office-door.

>open door
You open Office-door.

* * *

>e
(first opening kitchenn door)
It seems to be locked.

>unlock door with key
Which do you mean, kitchen-key or office-key?

>unlock door with kitchen-key
(kitchenn door with kitchen-key)
You unlock kitchenn door.

>e
(first opening kitchenn door)

kitchen
Counters run along the north and east walls. Two sinks are on the north wall, a refrigerator is on the east wall, and an oven and stove on the west wall. A knife sits on the north counter, next to the sinks.

You can see kitchenn door and refrigerator (closed) here.

>take knife
Taken.

>open refrigerator
You open refrigerator, revealing Demon head.

The demon head floats and follows you. It looks hungry??

>give demon head snickers
You place the snickers bar in the mouth of the demon head and it spits a rusty key back out at you.

>take key
Which do you mean, attic-key, kitchen-key or office-key?

>w
I only understood you as far as wanting to take west.

>w
North hall
Three doorways are in this hall. The doorway to the west opens to a dining room, the door to the east seems to be a kitchen, and there is a mysterious door at the end of the hall.

You can see kitchenn door and stairs here.

>e
kitchen
Counters run along the north and east walls. Two sinks are on the north wall, a refrigerator is on the east wall, and an oven and stove on the west wall. A knife sits on the north counter, next to the sinks.

You can see kitchenn door and refrigerator (empty) here.

* * *

>w
North hall
Three doorways are in this hall. The doorway to the west opens to a dining room, the door to the east seems to be a kitchen, and there is a mysterious door at the end of the hall.

You can see kitchenn door and stairs here.

>s
Main room
A large dusty room with couches in the middle and a few shelves pressed against the walls. A small chandelier hangs from the ceiling. To the West, North, and East are dark hallways.

* * *

>w
Library
The library's walls are filled with books. You see a desk with a lit candle in the middle of the room. Weird, this house is supposed to be deserted.

>e
West Hall
You see an open door at the end of the hall. A dim light seems to be coming from inside the room.

* * *

>e
Main room
A large dusty room with couches in the middle and a few shelves pressed against the walls. A small chandelier hangs from the ceiling. To the West, North, and East are dark hallways.

>n
North hall
Three doorways are in this hall. The doorway to the west opens to a dining room, the door to the east seems to be a kitchen, and there is a mysterious door at the end of the hall.

You can see kitchenn door and stairs here.

>open mysterious door
It seems to be locked.

>unlock mysterious door with attic-key
You unlock mysterious door.

>n
You can't go that way.

>u
Attic
A dark room that seems to be full of abandoned things like couches and stuff. the moon comes through the window and casts shadows across the room.

You can see stairs and window (closed) here.

* * *

>turn on flashlight
Now that your flashlight is on, you feel safer, but also like a character in a scary movie.

Main room
A large dusty room with couches in the middle and a few shelves pressed against the walls. A small chandelier hangs from the ceiling. To the West, North, and East are dark hallways.

>go west
West Hall
You see an open door at the end of the hall. A dim light seems to be coming from inside the room.

>go west
Library
The library's walls are filled with books. You see a desk with a lit candle in the middle of the room. Weird, this house is supposed to be deserted.

On library desk is office-key.

>take office-key
Taken.

* * *

>go east
West Hall
You see an open door at the end of the hall. A dim light seems to be coming from inside the room.

>go east
Main room
A large dusty room with couches in the middle and a few shelves pressed against the walls. A small chandelier hangs from the ceiling. To the West, North, and East are dark hallways.

>go east
East Hall
You see a door at the end of the hall.

You can see East door here.

>unlock door
What do you want to unlock East door with?

>office-key
You unlock East door.

>open door
You open East door.

>go east
office
A small room with a tacky rug spread on the floor.

You can see East door and cabinet (closed) here.

>open cabinet
You open cabinet, revealing kitchen-key.

* * *

>take kitchen-key
Taken.

>go west
East Hall
You see a door at the end of the hall.

You can see East door here.

>go est
You can't see any such thing.

>w
Main room
A large dusty room with couches in the middle and a few shelves pressed against the walls. A small chandelier hangs from the ceiling. To the West, North, and East are dark hallways.

>n
North hall
Three doorways are in this hall. The doorway to the west opens to a dining room, the door to the east seems to be a kitchen, and there is a mysterious door at the end of the hall.

You can see kitchenn door here.

>go east
(first opening kitchenn door)
It seems to be locked.

>open door
(kitchenn door)
It seems to be locked.

* * *

>unlock door
What do you want to unlock kitchenn door with?

>kitchen-key
I didn't understand that sentence.

>unlock door with kitchen-key
(kitchenn door with kitchen-key)
You unlock kitchenn door.

>open door
(kitchenn door)
You open kitchenn door.

>go west
Dining room
A long table that seats ten people sits in the middle of the room.

>go east
North hall
Three doorways are in this hall. The doorway to the west opens to a dining room, the door to the east seems to be a kitchen, and there is a mysterious door at the end of the hall.

You can see kitchenn door here.

>open door
(kitchenn door)
That's already open.

>go east
kitchen
Counters run along the north and east walls. Two sinks are on the north wall, a refrigerator is on the east wall, and an oven and stove on the west wall. A knife sits on the north counter, next to the sinks.

You can see kitchenn door and refrigerator (closed) here.

>x refrigerator
A standard one-door refrigerator. It's starting to rust.

>open refrigerator
You open refrigerator, revealing Demon head.

The demon head floats and follows you.

>take key
You can't see any such thing.

>x knife
A large cleaver that is particularly shiny. When you hold it up, you see something dark move behind you in its reflection.

The demon head floats and follows you.

>give snickers bar
(to yourself)
You can't give snickers bar to yourself.

The demon head floats and follows you.

>give snickers bar to demon head
You can only do that to something animate.

* * *

>turn on flashlight
Now that your flashlight is on, you feel safer, but also like a character in a scary movie.

Main room
A large dusty room with couches in the middle and a few shelves pressed against the walls. A small chandelier hangs from the ceiling. To the West, North, and East are dark hallways.

>go w
West Hall
You see an open door at the end of the hall. A dim light seems to be coming from inside the room.

>w
Library
The library's walls are filled with books. You see a desk with a lit candle in the middle of the room. Weird, this house is supposed to be deserted.

On library desk is office-key.

* * *

>e
(first opening East door)
It seems to be locked.

>unlock door
What do you want to unlock East door with?

* * *

>go east
(first opening kitchenn door)
It seems to be locked.

>unlock door
What do you want to unlock kitchenn door with?

* * *

>key
I didn't understand that sentence.

>kitchen-key
That's not a verb I recognise.

>unlock door with kitchen-key
(kitchenn door with kitchen-key)
You unlock kitchenn door.

* * *

>give snickers bar
(to Demon head)
You place the snickers bar in the mouth of the demon head and it spits a rusty key back out at you.

The demon head floats and follows you.

>i
You are carrying:
  attic-key
  kitchen-key
  office-key
  flashlight (providing light)

The demon head floats and follows you.

* * *

>turn on flashlight
Now that your flashlight is on, you feel safer, but also like a character in a scary movie.

Main room
A large dusty room with couches in the middle and a few shelves pressed against the walls. A small chandelier hangs from the ceiling. To the West, North, and East are dark hallways.

>x me
You are a giant crab.

* * *

>x desk
(library desk)
An old wooden desk with a single drawer that seems to be unlocked.  A key and matches sit next to the lit candle.

>open drawer
A severed hand jumps out at you and grabs your arm. You try to beat it away with your flashlight, but it grabs the flashlight instead. You drop it and run.

Darkness
It is pitch dark, and you can't see a thing.

>undo
Library
[Previous turn undone.]

>e
West Hall
You see an open door at the end of the hall. A dim light seems to be coming from inside the room.

* * *

>e
East Hall
You see a door at the end of the hall.

You can see East door here.

>unlock door
What do you want to unlock East door with?

* * *

>open door
You open East door.

>e
office
A small room with a tacky rug spread on the floor.

You can see East door and cabinet (closed) here.

>open cabinet
You open cabinet, revealing kitchen-key.

>x cabinet
dusty.

In cabinet is kitchen-key.

>take kitchen-key
Taken.

* * *

>w
North hall
Three doorways are in this hall. The doorway to the west opens to a dining room, the door to the east seems to be a kitchen, and there is a mysterious door at the end of the hall.

You can see kitchenn door and stairs here.

The demon head floats and follows you. It looks hungry??

>give snickers bar
(to Demon head)
You place the snickers bar in the mouth of the demon head and it spits a rusty key back out at you.

The demon head floats and follows you. It looks hungry??

* * *

As a dare, your friends tell you to walk through an acclaimed haunted house and open the upstairs window to prove you made it through. You stand inside the house's main room. The door closes behind you.

haunted house
An Interactive Fiction by Melissa Oshiro
Release 1 / Serial number 140917 / Inform 7 build 6L02 (I6/v6.33 lib 6/12N) SD

Darkness
It is pitch dark, and you can't see a thing.

>west
West Hall
You see an open door at the end of the hall.

>w
Library
The library's walls are filled with books. You see a desk with a lit candle in the middle of the room. Weird, this house is supposed to be deserted.

>take key
Taken.

>east
West Hall
You see an open door at the end of the hall.

>east
Main room
A large dusty room with couches in the middle and a few shelves pressed against the walls. A small chandelier hangs from the ceiling. To the West, North, and East are dark hallways.

>east
East Hall
You see a door at the end of the hall.

>unlock door
What do you want to unlock East Door with?

* * *

>unlock door with key
You unlock East Door.

>east
You can't go that way.

>open door
You open East Door.

>east
You can't go that way.

>west
Main room
A large dusty room with couches in the middle and a few shelves pressed against the walls. A small chandelier hangs from the ceiling. To the West, North, and East are dark hallways.

>north
North hall
Three doorways are in this hall. The doorway to the west opens to a dining room, the door to the east seems to be a kitchen, and there is a mysterious door at the end of the hall.

You can see Kitchenn door here.

>west
Dining room
A long table that seats ten people sits in the middle of the room.

>east
North hall
Three doorways are in this hall. The doorway to the west opens to a dining room, the door to the east seems to be a kitchen, and there is a mysterious door at the end of the hall.

You can see Kitchenn door here.

>east
(first opening Kitchenn door)

kitchen
Counters run along the north and east walls. Two sinks are on the north wall, a refrigerator is on the east wall, and an oven and stove on the west wall. A knife sits on the north counter, next to the sinks.

You can see Kitchenn door and refrigerator (closed) here.

>open refrigerator
You open refrigerator.

>x contents
You can't see any such thing.

* * *

As a dare, your friends tell you to walk through an acclaimed haunted house and open the upstairs window to prove you made it through. You stand inside the house's main room. The door closes behind you.

haunted house
An Interactive Fiction by Melissa Oshiro
Release 1 / Serial number 140917 / Inform 7 build 6L02 (I6/v6.33 lib 6/12N) SD

Darkness
It is pitch dark, and you can't see a thing.

>x me
It is pitch dark, and you can't see a thing.

>turn on flashlight
Now that your flashlight is on, you feel safer, but also like a character in a scary movie.

Main room
A large dusty room with couches in the middle and a few shelves pressed against the walls. A small chandelier hangs from the ceiling. To the West, North, and East are dark hallways.

>x m
You can't see any such thing.

>x me
You are a giant crab.